1111111
1S1   1
1 1 1 1
1     1
1 1 1 1
1 1    
1111111
